30,30
999999999999999999999999999999
900000000000000000000000000009
900000000000000000000000000009
900000000000000000000000000009
903300000003300000003300000009
903300000003300000003300000009
903300000003300000003300000009
900000000000000000000000000009
900002220000022200000000000009
900002220000022200000000000009
900000000000000000000000000009
900000000000000000000000000009
900000000000000000000000000009
900000004000000000000040000009
900000000000000000000000000009
900000000000000000000000000009
900000004000000000000040000009
900000000000000000000000000009
900000000000000000000000000009
900000000000000000000000000009
900022200000000002220000000009
900022200000000002220000000009
900000000000000000000000000009
903300000003300000003300000009
903300000003300000003300000009
903300000003300000003300000009
900000000000000000000000000009
900000000000000000000000000009
900000000000000000000000000009
999999999999999999999999999999